###################################################################################################
# #     #     # #       #     #     #     #                 #   #     #     #       #       #     #
# # # ### # # # # # ##### # # # ### # # # # ### ########### ### # # # ### # # ### # # ##### ##### #
# # #     # # # # #       # # # # #   # # #   #         #     #   # #   # # # #   # #     #     # #
# # ####### # # # ######### # # # ##### # ### ######### ##### ##### ### # # ### ### # ### ##### # #
#   #     # # # # #       # # #   #   # #   # #     #   #   #     #   #   #   # #   # #   #   #   #
# ### ### # # # # # ####### ##### # # # # ### # ### # ### # ##### # # ####### # # ##### ### ##### #
#   # #     #   # # #     #     # # #   # #   # # # #     # #   # # # #     # # #       #   #     #
### # ####### ### # # ### ##### # # # ##### ### # # ### ### # ### # # # # ### # ######### # # #####
#   #   #   # #   #     #     #   # # #     #   # #   #   # #   # # # # # #   #         # # # #   #
# ##### # ### # ######### ### ##### ### ##### ### ### ##### # # # ### ### # ########### # ### # # #
#   #   #     #         #   #     #     #   # #     # #     # # #   # #   #   #         #       # #
### # ### ############# ### ##### ####### ### # # # # # ##### # ### # # ##### # ####### ###########
#   # #   #       #   #   #   #   #       #   # # # # # #     #   #   #     #   #     # #   #     #
##### # ####### # ### ### ##### ### ##### # ##### ### # ##### ### ####### ##### # ### # # # # ### #
#     # #   #   #     # # #     #   #     #     #       #   #   #         #   # # # # # # #   #   #
# ##### # # # ####### # # # ##### ### ### ##### ######### # ##### ### ##### # # # # # ### ##### ###
#     #   #   #   #   # # # #   # # #   #   # #     #     #     #   # #     #   # # #     #   #   #
# ### ######### # # ### # # # # # # ### ### # ##### # # ####### ##### # ######### # ####### ##### #
# # #   #       # #   # # #   #       # #     #     # # #     #       # #   #     #   #     #S    #
# # ### # # ######### # # ### ######### # ##### ##### # # ### ####### # # ### ##### ### # # #######
# #   # # #   #  E    # #   #   #       # #     #   # # #   #   #     # # #   #         # # #     #
# # # # ##### # ####### ### ##### ##### ### ##### ### # ### # ### ##### # # ######### ### # ##### #
# # # #   #   #   #       # #   #     # #   #   #     # # # #     #   # # #     #   #   # #       #
# # ##### # ##### # ##### # # # ##### # # ### # ### ### # # ####### # # # ##### # # ##### #########
#   #   # # #     # #     # # #   #   # #     #   #   # #       #   #       # #   #     # #       #
##### # # # # ####### # ### # ### # ### ######### ##### ######### ######### # ######### # # ##### #
#   # # # # # #   #   # #   # #   # #   #       #     #           #     #     #       # #     #   #
# # # # # # # # # # # ### ### # ### # ##### ### ##### ############# ### ##### # ### ### # ##### # #
# #   #   #   # #   # #   #   #     # #     #       #             # # #   #   # # # #   # #     # #
# ### ##### ### ##### # ### ######### # ####### ################# # # ### # ### # # # ##### ##### #
# #   #   #     # #   # #     # #   # #   #   # #           #   #   # #   # # #   # # #     #     #
# # ### # ####### # ### ##### # # # # ### # # ### ### ##### # ####### # ### # # ### # ### ### #####
# # # # # #       #   # #     # # #   #   # # #   # # #   # #         # #     # #   # #   #   #   #
# # # # # ####### ### # # ##### # ##### ### # # ### # ### # ### # ### # ####### # # # # ### ### # #
# #   # # #     #     #   # #     #         #       # #   #   # # # # #         # # # #   # #   # #
# ##### # # ### ########### # ##################### # # # ### ### # # ########### ### # # # # #####
#   #   # #   # #     #     #           #   #   #   # # #   #     #   #     # #   #   # # # #     #
# # # ### ### # # ### # # ############# # # # # ##### # ########### ##### # # # ### ##### # ##### #
# #     #     #     #   #                 #   #       #                   #   #           #       #
