####################
           #   #   #
 ##### ### # # # # #
   #   #   # #   # #
## # ####### ##### #
 # #       #     # #
 # ####### # ##### #
   #   # #   #     #
 ### # # ##### ### #
     #   #     # # #
######## # ##### # #
   #     #     # # #
 ### ######### # # #
   #         # #   #
## ##### ##### #####
   #     #   #     #
 ### ##### # ##### #
       #   #     # #
 ####### # ##### # #
 # #     # #   #   #
 # # ##### # # ### #
 # #     # # #   # #
 # ##### ### ### # #
   #   #   #  S# # #
## # # ### ##### ###
 #   #E#       #   #
 ##### # ######### #
     # # #       # #
 ### # # # ### ### #
 #   # # #   #   # #
 # ### # # ##### # #
 #     #   #   # # #
###### ##### # # # #
     # #   # # # # #
 ### # # # # # # # #
   # # # # # # # # #
 # # ### # # # # # #
 # #     #   #   # #
 # ### ####### ### #
 #   # #     # #   #
 ### ### ### ### ###
   #   # # #     # #
## ### # # ####### #
     #             #
####################
