#   #     #   #     
# # # ### # # # ### 
# #   #   # #     # 
# ##### ### ####### 
# #   # #   #   #   
# # # # # ### # # # 
# # # #   #   # # # 
# # ####### ### # ##
# #         #   #   
# ####### # # ##### 
#       # # #     # 
####### ### ### ### 
# #   # #   #   #   
# # # # # ####### ##
#   #     #     #   
# ### ##### ### ### 
# # #   #   # # #   
### ### # ### # # # 
#   #   # #       # 
# ### ### ######### 
#   #   #     #     
### ### ##### # ####
# # # # # #   # #   
# # # # # # ##### # 
# # #   # #       # 
# # # ### ######### 
#   #   #   #   #   
# ##### # # # # # ##
#     # # #   # #   
##### # # ##### ### 
#   # # #     # #   
###S# # ##### ### # 
#   # #     #   # # 
# ### ##### ### # ##
# #   # #   #   #   
# # ### # ### ##### 
# #   #   # #     # 
# ### # ### # # ### 
#   # #   #   # #   
### # ### ##### # # 
#   # # E       # # 
# ### ######### # # 
#   #       #   # # 
# # ####### ##### # 
# #               # 
