#       #                   #           #   #   #             #             #         #           #
# ####### ####### ##### ##### # ####### # # # # ########### # # ######### ### ##### # ### ##### # #
# #   #   #     #     # #   # # #   # #   #   #           # # # #   #   #     #     #   # #     # #
# # # # ### ### ##### # # # # # # # # ################### # # # # ### # ####### ####### ### ##### #
#   #   #   # #   #   # # #   # # #   #     #       #   # # #     #   # #       #     # #   #     #
# ######### # ### # ### # ##### # ### # # ### ### # # # # # ##### # ### # ####### ##### # ##### ###
#       #   #   # #   # # #   # # # # # # #   # # # # # # # #   # # # # # #             #     # # #
####### # ### # # ### ### # ### # # # ### # ### # ### # # ### # ### # # # ### ############### # # #
#     #   # # #   # #       #   # #       # #   #     # #     # #   #   #   #         #       # # #
# ### ##### # ##### ######### ### # ####### # # ####### ####### # ### ##### ######### # ####### # #
# #   #   #           #       #   # #     # # #       #       # # # #       #         #   #       #
### ### # # ######### # ####### ### # ### # ##### ### ### # ### # # ### ############# ### ####### #
#   #   #   #     #   #     #   #   #   # #     # #   #   # #   # #   # #           #   #       # #
# ### ####### ### # ####### ### ####### # ##### # ##### ### # ### # ### # ####### # ### ####### ###
# #   #   #   #   # #     #   #       # #   #   #   #   #   #     #     # # #   # #   # #     #   #
# # ### ### ### ##### ### # # ####### # ### # ##### # ### ####### ####### # # # ### # # # ### # # #
# # #   #   #         # # # #       #     #   #     # #         # #   #   # # #   # # #   #   # # #
# # ### # ############# # # ####### ##### ####### ### ########### # # # ### # ### ### ##### ##### #
# # #   #       #         #       #   #   # #     #   #   #       # #       # # #     #   # #     #
# # # # ####### ##### ##### ##### ### # ### # # ### ### # # ##### # ######### # # ##### # # # ### #
#   # #   #   # #   #     # #   # #   #   #   #   #     #   #   # # #   #     #   #   # # #   # # #
# ### ### ### # # # ##### ### # ### ##### ####### ########### # ### # # # ##### ### # ### ##### # #
#   #   #   # # # #   #       #     #   #                 #   #     # # #   #     # #  S#   #     #
### # # ### # # # ### ####### ####### ############# ####### ######### ##### ####### ##### # # #####
#   # # #   # #     #   #     #     # #     #   #   #     #     #   #     #     #   #     #   #   #
# ##### # ### ####### # ##### # ### # # # ### # # ### ### ##### ### # # # ##### # ### ########### #
#       # #     #   # # #   # # # # #   #     #   #     #     # #   # # #     # #   # #         # #
######### ##### # # ### # # # # # # ##### ######### ##### # ### # ### # ##### # ### # ####### # # #
# #     #       # #   #   # # # # #     # #         # #   # #   #     # #   # #   # # #   #   #   #
# # # ##### ##### ### ##### ### # ##### ### ######### # ##### ######### # ### ### # # # # # ##### #
# # #   #   #   #   # #     #   #     #     #         #       #   #     #     # # # #   # # #   # #
# # ### # ### # ### # # # ### ### ########### ####### ######### # # ##### ##### # # ##### # # # # #
# # # #   # # #     # # # #   #               #   #   #     #   # # #     #     # # # #   # # # # #
# # # ##### # ####### # # # ### ######### ####### # ### ### # # # # # ####### # # # # # ### # # # #
# #       # #     #   # # #   # #   #   #   #     # #   # # # # # # #   #     # # # #   #   # # # #
# ####### # ##### # ### ##### # # ### # ### # ### # # ### # # # # # ### # ### ### # ### ### # ### #
#         #     # #     #     #   #   #     # #   #   #   # # # # #   # # #   #   #   #   # # #   #
# ############# # ####### ######### ######### ######### # # ### # ### # # # ### ##### ### # # # ###
#               #                   #                   #       #     #   #   #       #     #E    #
###################################################################################################
